GGGGGGGGTTGGGGGGGGGTTG
GGGGGGGGTTGGGGGGGGGTTG
GTTGGGGGGGGGTTGGGGGGGG
GGGGGGGGGGGGGGGGGGGGGG
GGGGGGGGGGGGGGGGGGGGGG
GGGGGGGGGGGGGGGGGGGGGG
GGGGGGGGGGGGGGGGGGGGGG
GGGGGGGGGGGGGGGGGGGGGG
GGGGGGGGGGGGGGGGGGGGGG